0111111111111111111111111111111111111111111111111111111111111110
0110001000100010001100000100001000000000100000000000000000000010
0110111111011101111111111111111111111111111111111111111111111010
0110100000100000000100000000000000000000000000000000000000100010
0110101111111111111111111111111111111111111111111111111111111110
0111111100000000000000000000000000000000000000000000000011111110
0111111111111111111111111111111111111111111111111111111111111010
0111111110000000000000011111111110000000000000000000111111111111
0111111110111111111111111111111111111111111111111111111111111110
0111111110100000000000000000000000000000000000000011111111111110
0111111110101111111111111111111111111111111111111111111111111010
0111111111111100000000000000000000000000000000111111111111111111
0111111111111111111111111111111111111111111111111111111111111110
0111111111111110000000000000000000000011000111111100111111111110
0111111211111110111111111111111111111111111111111111111111111010
0111111111111110100000000000000000000000000000000011111111111111
0111111111111110101111111111111111111111111111111111111111111110
0111111111111111111100000000000000000011111111111111111111111110
0111111111111111111111111111111111111111111111111111111111111010
0111111111111111111110000000000000111111111111111111111111111111
0111111110100011111110111111111111111111111111111111111111111110
0111111111111111111110100000000011111111111111111111111111111110
0111111111111111111110101111111111111111111111111111111111111010
0111111111111111111111111100001111111111111111111111111111111010
0111111111111111111111111111111111111111111111111111111111111111
0111111111111111111111111111111111111111111111111111111111111110
0111111111111111111111111111111111111111111111111111111111111110
0000000000000000000000000000000000000000000000000000000000000000