0000000000
0111111110
0110011110
0110011110
0111111110
0111100110
0111120110
0111111110
0000000000